Outdoors & Recreation : На открытом воздухе и Отдых

Gym / Fitness Center : Тренажерный зал / Фитнес-центр

Mediterranean Restaurant : Средиземноморский ресторан

Hotel : Отель

Fountain : Фонтан

Multiplex : Мультиплекс

Shopping Mall : Торговый центр

Asian Restaurant : Ресторан азиатской кухни

Park : Парк

Opera House : Опера

Korean Restaurant : Корейский ресторан

Pizza Place : Место пиццы

Movie Theater : Кинотеатр

Restaurant : Ресторан

Wine Shop : Винный магазин

Bath House : Баня

Bar : Бар

Spa : Спа

Gym : Тренажерный зал

Turkish Restaurant : Турецкий ресторан

Buffet : шведский стол

River : Река

Tennis Court : Теннисный корт

Pedestrian Plaza : Педестрианская Плаза

Gourmet Shop : Изысканный магазин

Italian Restaurant : Итальянский ресторан

Coffee Shop : Кофейня

Middle Eastern Restaurant : Ближневосточный ресторан

Steakhouse : Стейк-хаус

Theater : Театр

Cocktail Bar : Коктейль-бар

Dessert Shop : Десертный магазин

American Restaurant : Американский ресторан

Skating Rink : Каток

Bakery : Булочная

Eastern European Restaurant : Восточноевропейский ресторан

Japanese Restaurant : Японский ресторан

Pool : Бассейн

Golf Course : Поле для игры в гольф

French Restaurant : Французский ресторан

Sushi Restaurant : Ресторан суши

Wine Bar : Винный бар

Record Shop : Магазин грамзаписи

Boutique : Бутик

Comfort Food Restaurant : Ресторан Comfort Food

Burger Joint : Заведение бургера

Plaza : Площадь

National Park : Национальный парк

Ski Area : Зона катания на лыжах

Nightclub : Ночной клуб

Yoga Studio : Студия йоги

BBQ Joint : Заведение барбекю

Scenic Lookout : Живописное наблюдение

Gift Shop : Сувенирный магазин

Chinese Restaurant : Китайский ресторан

Pub : Паб

Art Gallery : Художественная галерея

Electronics Store : Магазин электроники

Bookstore : Книжный магазин

Other Great Outdoors : Другая природа

Sporting Goods Shop : Магазин спортивных товаров

Lounge : Гостиная

Irish Pub : Ирландский паб

Garden : Сад

Food & Drink Shop : Продуктовый магазин

German Restaurant : Немецкий ресторан

Soccer Field : Футбольное поле

Caucasian Restaurant : Белый ресторан

Cosmetics Shop : Магазин косметики

Grocery Store : Продуктовый магазин

Cupcake Shop : Магазин капкейка

Sports Club : Спортивный клуб

Ski Chairlift : Лыжный кресельный подъемник

Dance Studio : Студия танца

College Quad : Двор колледжа

Cable Car : Вагон фуникулера

Hotel Bar : Бар отеля

Modern European Restaurant : Современный европейский ресторан

Brewery : Пивоварня

Furniture / Home Store : Мебель / Домашний магазин

Neighborhood : Прилегающая территория

Supermarket : Супермаркет

Fish & Chips Shop : магазин рыб

Clothing Store : Магазин одежды

Stadium : Стадион

Concert Hall : Концертный зал

Gaming Cafe : Игровое кафе

Gastropub : Гастропаб

Rest Area : Область отдыха

Mountain : Горы

Beach : Пляж

Resort : Курорт

